0010100000
0110110000
0111110000
1101011001
0111110011
0011100010
1111110011
1011111001
0011111111
0110111100