□ □ ■ □ ■ □ □ □ □ □
□ ■ ■ □ ■ ■ □ □ □ □
□ ■ ■ ■ ■ ■ □ □ □ □
■ ■ □ ■ □ ■ ■ □ □ ■
□ ■ ■ ■ ■ ■ □ □ ■ ■
□ □ ■ ■ ■ □ □ □ ■ □
■ ■ ■ ■ ■ ■ □ □ ■ ■
■ □ ■ ■ ■ ■ ■ □ □ ■
□ □ ■ ■ ■ ■ ■ ■ ■ ■
□ ■ ■ □ ■ ■ ■ ■ □ □