□ ■ □ ■ □
□ ■ ■ ■ □
□ □ ■ □ □
■ □ ■ □ ■
□ ■ ■ ■ □