□ □ □ □ □ □ □ □ □ ■ ■ ■ □ □ □
□ □ □ □ □ □ □ □ ■ ■ ■ ■ ■ □ □
□ □ □ □ □ □ □ ■ ■ ■ ■ □ ■ ■ ■
□ □ □ □ □ □ □ ■ ■ ■ ■ ■ ■ ■ ■
□ □ □ □ □ □ □ □ ■ ■ ■ ■ ■ □ □
□ □ □ □ □ □ □ □ □ ■ ■ ■ □ □ □
□ □ □ □ □ □ □ □ ■ ■ ■ ■ ■ □ □
■ □ □ □ □ □ ■ ■ ■ ■ ■ ■ ■ ■ □
■ ■ ■ □ □ ■ ■ ■ □ □ □ ■ ■ ■ □
■ ■ ■ ■ ■ ■ ■ □ ■ ■ ■ □ ■ ■ □
□ ■ ■ ■ ■ ■ □ ■ ■ ■ ■ □ ■ ■ □
□ ■ ■ ■ ■ ■ ■ ■ ■ □ □ ■ ■ □ □
□ □ ■ ■ ■ ■ ■ ■ ■ ■ ■ ■ □ □ □
□ □ □ □ ■ ■ □ ■ ■ ■ □ □ □ □ □
□ □ □ □ □ □ ■ ■ ■ ■ ■ ■ □ □ □